111111111
1CC110101
10CEP1001
111111111
