1111111111
1C0CP0C011
1000e10011
1111111111
