11111111111111
1P0001C0000001
10C00100000101
1000C100111101
101111001C0001
100000001000E1
11111111111111
