1111E11111
1C0CP0C011
1111111111
