111111111
1C0CP0C01
1000E1001
111111111
