111111111
100000C01
10CEP1001
1000CC001
111111111
