1111111111
1P1C001E01
10C1101101
1000000001
1111111111
