11111111111111
1P0001C0F00001
10000000000101
1000C1001FF1E1
11111111111111
